5 5
XXXXX
XS GX
X X X
X G X
XXXXX
